XXXXXXXXXXX
XS        X
XX X  XE  X
XX X  XXXXX
X  X  X   X
X  X  X   X
X  X    X X
XXXX  XXX X
X  X    XXX
X  XX  XX X
X   X     X
XXXXXXXXXXX
